NO ./textures/nord.xpm
SO ./textures/sud.xpm
WE ./textures/ouest.xpm
EA ./textures/est.xpm

F 232,222,146
C 88,66,92


		
      
111111111
100000001
1000SX001
100000001
100010001
100010001
100000001
100000001
100000001
100000001
111111111
