NO ./textures/nord.xpm
SO ./textures/sud.xpm
WE ./textures/ouest.xpm
EA ./textures/est.xpm

F 232,222,146
C 88,66,92


		
      
111111111
100000001
1000S0D01
100000001
10001000D
100010001
1000D0001
100010001
100010001
100000001
111111111
