NO ./textures/nord.xpm   			
SO ./textures/sud.xpm    			
WE ./textures/ouest.xpm  			
EA ./textures/est.xpm   			

F    232,   222    , 146   
C                 88,66,92


		
      
111111111
11000 001
  1000S01   
110000001
100010011
1000101
100000011
100000001
100000001
100000001
111111111
